1111111111111111111
1001000000001000001
1011011101011101101
1011011101011101101
1000000000000000001
1011010111110101101
1000010001000100001
1111011101011101111
1001010000000101001
1111010110110101101
1000P00100010000001
1111010110110101111
1001010000000101001
1111010111110101111
1000000001000000001
1011011101011101101
1001000000000001001
1000010001C00100001
1011111101011111101
10E00000000000000M1
1111111111111111111