1111111111111
101100000C001
1100011111001
1P1001E000001
1111111111111