11111111111111111111
1MMMMMMMMMMMMMMMMMM1
1MPMMMMMMMMMMMMMMMM1
1M0M000M0CMM000MMMM1
1M000M000MMM0M0MMMM1
1M0MMMMMMM000M000001
1M000M000M0MMM0MMM01
1MMM0M0M0M0MMM00MMC1
1MMM000M000MMMMEMMM1
1MMMMMMMMMMMMMMMMMM1
11111111111111111111