111111111111111111111
1MMMMMMMMMMMMMMMMMMM1
1M0MMMMMMMMMMMMMMMMM1
1MPM000M0CMM000MMMMM1
1M000M000MMM0M0MMMMM1
1M0MMMMMMM000M00000M1
1M000M000M0MMM0MMM0M1
1MMM0M0M0M0MMM00MMCM1
1MMM000M000MMMMEMMMM1
1MMMMMMMMMMMMMMMMMMM1
111111111111111111111