11111111111111111111
11P00000000000000001
10000000C00000000001
10000M00000000001001
10001000000001000001
1000000010000000M001
1011000011000000C001
100000000001100E0001
11111111111111111111