11111111111111111111
11P00000000000000001
10000100000000000001
10000000000000001001
10001000000001000001
10000000100000000001
101100011000000C00E1
10000000000110000001
11111111111111111111