11111111111111111111
10000000100000000001
1011000110001P000001
10000000000110000001
10001000000000E10001
11111000010010C00001
11111111111111111111