11111111111111111111
11P00000000000000001
10000000000000000001
10000M00000000001001
10001000000001000001
1000000010000000M001
101100001100011E1101
10000000000110000001
11111111111111111111